###########################################################################################################################################################
#.........................................................................................................................................................#
#==============================================================#=============........============..=========....#............................============.#
#................................====#=====.....======.........#................................................#.........................................#
#....................................#........===..............#................................................#.........................................#
#...................#..=========.....#.........................#................................................#.........................................#
#...................#................#.........................#.......=========................................#.........................................#
#...................#................#......=====..............#................==========......................#...........#...................#.........#
#===================#================#==...====================#======#=====.....................=============..#..=========#==============....=#==.======#
#...................#................#.........................#......#..#......................................#...........#=========..........#.........#
#...................#................#.........................#......#..#.....................==...............#...........#...................#.........#
#...............#...#................#.........................#......#..#......................................#...........#...................#.........#
#...============#===#=..============.#=====================....#======#==#=================.......=======...==#=#===========#==============.....#=========#
#..#............#...#................#.........................#......#..#...........................#........#.#...........#...................#.........#
#..#..=======.......#....============#============.........====#======#==#===================........#========#=#====...====#=====.......=======#=====....#
#..#.................................#.................=====...#.====.#..#.........======.....................#.#...........#...................#.........#
#==#=========================....====#=======================..#.========#=====.........==============....====#=====.=======#=====.......===....#=======.=#
#..#..........................===....#.........................#.........#....................................#.............#...................#.........#
#..#..............................========.....................#......#..#....................................#.............#..............=====#===......#
#..#=====..........................^^^^^^..^^^^...^^^.......=======...........................................#.............#...................#.........#
#..#..............................=======...==.........========................................========....................^^^========^^..................#
#................S...................#.==============...^^^^^^..................................^^^^^^......................#..^^^^^^.....................#
#...............=============........#...............=========.................................==============...........================..................#
#.............................===....#.............................======......=^^^^^^.=====................................#.................^^^.........#
#...............................................................................^^^....==^^........................................==....................G#
#..........................................................................=================.................=======..==.............==.==================#
#=====....==============....============================================================....======================================.........===============#
###########################################################################################################################################################
