#################################################################################################################################################################################################
#............................................====.....====................===................====.........................................................===..........==.......................#
#...........................................=........=...................=................====........................=====....========..................=...............=......................#
#..........................................===......=...................=..................=..................................................==...===..=.................=.....................#
#..................==========..........==========..=...................=..................=.==...............................................=......=..=................====.........===........#
#.......................................=======...=...................====...............=....=.............................................=........==................==========...............#
#..........................................====..=......................................=......=....==.....................................=.........==.........................................#
#...........................................=...=.....................................====......=.....=...................................=............=........................................#
#..........................................=.=.=......................................==..=......==....=..................======.........===.......===..==......................................#
#.........................................=...====................................=====....=.....==.....=...............................................................................===.....#
#........................................=.....=....============........====................===.=..=.....=.............................................................................=........#
#.......................................=.....===.............=#====........=======........======...=.....=...........................................................................=.........#
#....============......============================..==========================........====...====..============..=====.============.....==========.=========...======........==================#
#.....................................=...........=.............=............==...........=======.....=.....=........................======.........................................=...........#
#=======....===========.========.=================================....===============================================..==================....===========..=====.............====================#
#...................................=...............=..........#..=........=....=...........=....========.....=...................................................................=.............#
#...............................====.................=.........#...====...=......=.........=......=............=...............................................==................=.....==.......#
#...............#.............................=========........#....=.====........======..=........=............=...............................................=...............=......=........#
#...............#......................................=.......#.....=.............=..=..=.........======........=.......===............#...............====.....=............#=......=.........#
#========================================.....===============================.......=..==========================================..=======================================....===....=..........#
#..............=#====..............#.................................................=..=.............................=............................................=................=...........#
#...............#....==............#...........................#......................=..=.............................=............................................==.............=............#
#....................=......................................................#.........==..=.............................=...............#.....................................#...=.............#
#.......===....==...=......==================...===================............==============........=====================....=========.=============.........====......==============..........#
#..................=...............#...........................#............#...............=3............................=..................===................................=...............#
#.................=.........................................................=====...........=..............................=............#.....................................#=................#
#................=.S..................====..............................................................^^^.=======........==..............................................====.................#
#...............=.============.........====^^^^^^^........................=======............................^^^^^........==^^^^^^..................................==^^^^^=..#4................#
#..............=........................=..=^^^^^..=========...............^^^^^.8....========...=================........=^^^^^^=...............3...................^^^^^^...#===..............#
#=......===......======.....==========.=============^==^^^^====..==========================.....................===================^^^===========================....=============.........=====#
#.........................................=........========..................==.======..................................=.........^^^^^^^.....^^^.........^^^^^^...............................G#
#..........................................====......................................................................===..........=========..======......============.............==============#
#===============================================....=====================.....=========================...======....=====..=====================================================================#
#################################################################################################################################################################################################
