#############################################################
#...........................................................#
#====#============..========.....=#=====....================#
#....#.........................===...===....................#
#....#.....................=..............#====#==========..#
#..=##=.....========^^^..========..===...=#====#==========..#
#...##.....#.........======.....^^^^^==.....................#
#...S.........=========.=====...###======...................#
#..============..==========================^^^=#====...=====#
#...#......................................###.............G#
#...............................................============#
#....=======================================================#
#############################################################
