#############################################################
#...........................................................#
#====#============..==========...=#=====....================#
#....#.........................===#=.=====#.................#
#....#............................#.......#====#==========..#
#..=##=.....========^^^..=========#=======#===.#==========..#
#...##...............======.....^^^^^=====#....#............#
#...S#........=========.=====.....#=======#....#............#
#..============..==========================^^^=#============#
#...#......................................................G#
#..........................................=================#
#....=======================================================#
#############################################################
