########################################################
#......................................................#
#......................................................#
#...........====...................====................#
#......................................................#
#.....^^^^..................B....................^^^^..#
#....................====..................====........#
#.................................B....................#
#..S.............====.............................G....#
#......................................................#
#..............U.......................................#
########################################################
