################################################################################
#..............................................................................#
#========....===========............===================..====.....===========..#
#.=============#===..===============================================.==========#
#..............#......................==#===============....======.............#
#....=================.====#......======#========.......=======================#
#................===.......#............#............====......................#
#...........===#=.#=======.#.....*......#............#...#...........====......#
#...S..........#....^^^^^.......========#==..........#...#.....................#
#..============#.========.^^^^.=====....#............#===#==...................#
#..............#.....#..........^^^......................#.....................#
#..............#......================......^^^^..............................G#
#..............#................................========..............=========#
#.....................................==========........===============........#
#====================================================================.....=====#
################################################################################
