###########################################################################
#....................................===..................................#
#.....========..============...=================...=....=====........=====#
#......=.....============................=........=.......................#
#.....=.....===............#....#...............................===.......#
#.....................6....#======.........=....=.........................#
#================.....====..======....==============================....==#
#..=....==========........^^...8........................====..............#
#.=S.................=^^^^========.....^^==.====.........=.......=========#
#.================...==========...===...=======...=...=...................#
#.............=...=........#...........=...==..^^^=...======..............#
#............=.....=..................=..===========..=.....=.............#
#...........=..............#.........=.................=.....=...........G#
#.........==.......................==...............======================#
#=================================..======================================#
###########################################################################
