############################################################
#..........................................................#
#.................*......................*.................#
#..............====...............====.....................#
#..........................................................#
#....U....................^^^^^..................====......#
#....................====............................B.....#
#.............................................*............#
#..........B..................====.........................#
#.....................====...................^^^^..........#
#..S.............====.................................G....#
#..........................................................#
############################################################
