###############################################################################################################
#.............................................................................................................#
#....................======...............................=======....................==========...............#
#..................................................................================....#......................#
#======================...========================......============........#.....====.#=====.================#
#.......##..................................................................#..............#...#..............#
#.......##..................................................................#=.............#...#..............#
#.......##..................====.......................=======...........#..#..........#...#...#..............#
#.......##.========...............===#......................................#=========.#...#...#..............#
#.......##...........................#................==========............#..........#...#...#....=========.#
#=======##====.....==========.......=#===========...=============........#.=#==========#===#..=#==============#
#..=====##=====........==============#===============================....#==#==========#===#===#==============#
#..=====#=======...==============....#============..==========.....======#==#==========#=======#==============#
#............S..................^^^^^^======................................#..........#...====.=====.........#
#...........==============...........#.^^^^.....*......................................#......................#
#.........................=================....==...........^^^^^........======.....^^^^........^========.....#
#.........................................................................^^^^....................^^^^^^.....G#
#.........................................=========================..=========================================#
#=============================================================================================================#
###############################################################################################################
