####################################################################################################################
#...............====.............===............................===....................===.........................#
#========================...........=...================....============................========....===============#
#..............=..===........====....=..............====......=...............===....===...=...............=======.#
#...====......=......=......=.........=.................=....=...................=......=..==......................#
#............===......=....=...........=.................=.==========.............=......=.........................#
#.....................==..=.............=.................==......#....==..........=......=........................#
#.....====#..............=...............=..............=========.#.====..........====.....=.......................#
#.........=.............=.......===.......=..............==.====...=..=..............=......=......................#
#..........=...........=...........=.....===......==========.=....=..=................=....===.....................#
#=================================..====================================================================..=========#
#............=.......=...............=...==.======.............==..==========..............=...=...................#
#..........====.....=.................=.=..=...................==.=.......................=.....=..................#
#..........S.......====................=.======...............=..=#........7.............=.....====................#
#.........==============.....................=.....===.......=..===........==......................................#
#=========....==================^^^^^.......===========^^^===..======^^^^==========..............====......========#
#..........................^^^...==...........==...........===========..==.......===.....1.........................#
#=============..=====================..========^^^^^===============================.....=============......========#
#.......................................^==^^..^^^^==========...................===................................#
#....................................===============..=........................==========^^^^......................#
#.................................................=..=..........................=.................................G#
#.................................................===.........................==.........==========================#
#....=======================================================...====================================================#
####################################################################################################################
