####################################################################################################################################################################
#..................................................................................................................................................................#
#...................#.................................................................................======...........=====.......................................#
#...................#.......=====............#.................................................................................................................===.#
#...................#........................#.....................................................................................................................#
#.====..========....====......==========.====#=====...=============...===========.......=========================================.....=====#=.....=====#====...====#
#======.....====......================....===#=================================================...=============......========#==========..=#===========#===========#
#...................#........................#......#.......................................................===...........#..#.............#...........#...........#
#...................#...................===..#......#....................#................................................#..#.............#...........#...........#
#...................#....#...................#......#....................#................................................#..#.............#...........#...........#
#...................#....#...................#......#....................#................................................#==#==...........#...........#...........#
#=====.....=========#====#============.....==#======#====================#=====...====....================================#==#======.======#=======================#
#...................#.===#===................#......#.....................................................................#..#.............#.......................#
#...................#....#...................#......#.......==========.......======.......................................#..#.............#...........#...........#
#...................#....#...................#......#....................#................................................#................#...........#...........#
#...================#====#===================#======#============........#=================........#.....=========...=====#================#=====.....=#===========#
#...................#........................#......#....................#.........................#..==..................#......#.........#...........#...........#
#...................#........................#......#....................#...............=====.....#.............................#.........#...........#...........#
#...................#....#...................#......#....................#.........................#.............................#.....................#...........#
#...==========..====#====#==================.#...===#=============..=====#=====^^^^^^============..#=============================#.====================#===========#
#...................#....#...................#......#....................#...........==============#.............................#.....................#...........#
#...................#....#...................#......^^^^^^^........========..========..............#.............................#.....................#...........#
#...................#....#...................#......#...............^^^^^^..............^=======...#.............................#.....................#...........#
#........................#...................#......=======...==..========................^^^^^....#....................===^^^=..#.....................#.......===.#
#........................#...............==....====.#..............................=============...=========......=======^^^^^=========..===============...........#
#.========..........=========.6.....................#........................==========............#^^^^^^^........^^^^^^=====.^^^^^^^....^^^^^.^^^^^^^#..........G#
#........S...........^^^^^^^..===.========..=======.#............................................========================...==========..===============#..=========#
#.......====================.......^^^^^^...........#..............................................#...................................................#...........#
#........................==....==========..........................................................................................................=====...........#
#..........................====.......======............................................................................................................=======....#
#========================....=======================================.....======================....==========..=======..===========================================#
####################################################################################################################################################################
