#########################################################################################################################################################################################################
#...........==..................................................................===.......................===.................................................====.......====.==........................#
#.............=................................................................=.........................=...........======......................................=======.....=..........................#
#..............=......................#........====...........................==...........====.........=......................====................................=........=.==........................#
#.....=========.=...=====..==========================..==============.......=============================================================.=======..=====================================================#
#................=....................=......=..................................................=====.=.....................................................=........=....=.=...........................#
#.................=..................=......=....................................................=...=..........====.........................................=........=..=.=............................#
#........#.........=................=......=.........======.......................................=.===...........=...........................................=........==.=.............................#
#........#..........=..............=......=...........................................===..........=.............=.............................................=.......===.==...........................#
#.....===............=............=...#..=...............................................=..........=...........=...........................=====...............=.....====.=............................#
#......=.............==..........=......=..............=====..............................=.....==...=.........=............................=....=.........#.....====..=====............................#
#.......=.......................=......===.......=========.................................=.......#..=....====.......#....................=......=...............=...=..=....====......................#
#........=.....................=......#...#.......====......................................=..........=...........====...................=........=.......#.....=...====.........=.....................#
#........#=................=========......#........==.......................................==.....#....=...........=.#..................=..........=...........=......=...........=....................#
#..........=..............==.=.....................==...===............................................===...........=..................=............=.....#...=......=.............=...................#
#==============....==========...=========..================================.......================================....=======..===================....=....#.=====..==.=================...=========....#
#............=.............===.......==..........===..=...=........................................#...................=..............=................=.....=........................=========.........#
#============.=...==============.....=....==============...================..======================#====...=========================.=......=============================........=========......========#
#........#.....=...............=.====...................=...=...................................=..#..................#..=..........=....................=.=.......................====.=...............#
#=========.....=========================...............=========.....==================........==============.....==========.......========.===========================================..=...===========#
#........#.......=..............===.......................=.=====.................................=#.......................===...==.......................==.....................=........=.............#
#......=========..==............=============.......====...=.......................................=..................#...........===...........................................=..........=............#
#=======.#....===.....=====...=======.......=======..=.=======================.....============.....===...===================...========.....==....==================================....===============#
#..............................^^^^...................=.^^^^^=................................=====.................................=.........................................=.........................#
#.........................=========..........================.=....................................#..................#..............=.....................#.................=..........................#
#......===..........==========.....=========............=======^^^^^^............^^^^^^^..............................#.......===.....=....................#................====........................#
#....................^^^^^^===..........==...............=^^^^....................^^^^^..............6.................................=................................................................#
#........S...........======...............................===========......^^^^..=======.........^^^==..................................=...............................................................#
#.......=========..........................................=.............................................................................====.......................*...................................#
#==========....==.......==.....=================....=============.======^^^======..=====================.==...=========..............==========.............=====.===....==.........====..=============.#
#............................................................=...........................................................................===.......=====...............................................G#
#.............................................................=.....=======..............................................==================.....^^^^^^===^^^...=========.....========^^^^^.....=========#
#..............................................................=..........................................................^^^^.^^^^^^^^^^^.........^^^^^........^^^^^^^.......^^^^^^....................#
#...............................................................=.......................................=======....===...=================....==============..============================..=======.....#
#===================...=========.....==========================================.....=====...........============================================....===========.......==============..==================#
#########################################################################################################################################################################################################
