###############################################
#.............................................#
#....................B..*.....................#
#....................====.....................#
#.............................................#
#..............====...........................#
#.............................................#
#..S.................U.....................G..#
###############################################
