###############################################
#.............................................#
#.......................*.....................#
#....................====.....................#
#...............*...=.........................#
#..............====...........................#
#...........=.................................#
#..S...........................#...........G..#
###############################################
