###############################################
#.............................................#
#....................B..*.....................#
#....................====.....................#
#.............................................#
#..............====...........................#
#..........................................G..#
#..S.................U........................#
###############################################
