#.............................................#
#....................B........................#
#....................====.....................#
#.............................................#
#..............====...........................#
#.............................................#
#..S..................G.......................#
###############################################
