###############################################
#.............................................#
#....................B..*.....................#
#....................====.....................#
#.............................................#
#..............====...........................#
#..........................................G..#
#..S..........................................#
###############################################
