###############################################
#.............................................#
#....................B..*.....................#
#....................====.....................#
#.............................................#
#..............====.........#.................#
#.............................................#
#..S.................U.........#...........G..#
###############################################
