####################################################################################################################################################
#..................................................................................................................................................#
#...................................................................................................========...........#...........................#
#......................=====..........#............................................#...................................#...........................#
#.....................................#............................................#.=========.........................#=======....................#
#.....................................#............................................#........=========..................#.#.........................#
#==================..========#========#====.==========#==================..........#=====================......========#=#===================..====#
#............................#........#...............#............................#.........=====...........#.........#.#.........................#
#====......==========...=====#======.=#===============#.=============......========#=========================#=========#=#=========================#
#..#.....#...#........=======#........#...............#.........====...........#...#.........................#.........#.#..==========.............#
#..#.....#...#...............#...#....#...............#........................#...#.........................#.........#.#.........................#
#..#.....#...#...............#........#...............#.............=======....#...#.........................#.........#.#.........................#
#==#=====#===================#=.======#===============#===================.....#.==#=.....===================#==..=====#=#======..=================#
#..#.....#...................#...#....................#....^^^^............====#...#...................................#.#.........................#
#==#=====#=..#............===#====...==================================......==#===#============......========..........=#=======...========..====.#
#..#.......==========........#.=======^^^^.....^^^^^^^^^^....=======...........#...#....................................=#==.......................#
#..#.........................#..^^^^^^======...==========..............==......#...#..............*.....................=#=====....................#
#............................#.========...............#..........====..........#...#..............====...................#.........................#
#...................=====^^^^^^^^=.............................................#...#.....======..........................#.........................#
#.S#.................^^^.^^^^^^^^..........................................======.......................=====............#.........................#
#==================================.........===========================.=======#=========^^^^^^^.^^^^^^^=^^^==...........#======...........=======G#
#..............................................................................#..................==================================...============#
#..............................................................................#..======================.................#.........................#
#..................................................................................................................................................#
#=========================================================..===========================...================================================.....====#
####################################################################################################################################################
