##############################################################################################################################################################################
#.............====..====........................................................................................====................===......................................#
#............=..........=............................................==========................................=.......................=.....................................#
#...........====...==....=....................................................................................=.........................=.............=====..................#
#.........................=................................................=====...........======............=...........................=.....................==========....#
#..........................=................................................==..............................=...====......................=..................................#
#..........==========.......=...............................................=..............................=.....==.....................====.................................#
#............................=..............................========.......=========......................=......==..................==...........====.......................#
#............................==.....................===..=========........=...........===................===....=..=................=............=...........................#
#=======================..............======================================....==...=......========.....=========..=..==========..=====================........======...====#
#.............====......=...............................=...............=......=....=.........................=......=............=............=.............................#
#.==.....................=...............................=#............=......=....=.........................=........=..........=.........====.......=====..................#
#...=.....................=................==.............=.........===......=....=......................====..........==......===...........=...............................#
#....=======...............=...............=..............#=................=....=...........===................==========.=====............=................................#
#.....=....===..............=.............=...............#.=..............=....=.............=..............................====..........==..................===...........#
#......=....=................=...........=...................=............=....=...............=...........................#=.......===...==.................=========.......#
#======================================.=.......========..#...========================..============================================.=...===================.===========..===#
#...........^^^^..========================================.....============..=..==============================....====================..=...=...=====.===========...=========#
#.S.........=====........==.....=.....=.........................=...........=.....................=....................===.#...........==...#...=............................#
#===========....=.....====.......=...=.............========.....==.........==......................=.................................===.....................................#
#....===.....=====...======....=================================================...========.....======.........========.......==.....===....=...==========..===========.....=#
#.................=.=..............=......................#...................*....^^^^^^............=.........................=............=........................===.....#
#=======.....============.=========...==========================================...==========........====............=============...====...=......=========........=========#
#...............=.=..=...........=........................#......................==========...........................^^^..^^^^^^...........#....................===.........#
#..............=.====........===========............................4..........=======..............................=============.................................=..........#
#.............=....=.........===..........============...============...........^^^^^.......====================.............==.========..............^^^^^^^....=======.....#
#............=....=........................^^^^^^^^^^.....^^^^^^^^^=====..===========........^^^^^^^^^^..^^^^^^...==........................#...................=...........G#
#...............==......................===========================........................=======================......................==========================..=========#
#=========....======......=========================.....===========..=======================================================================.....============================#
##############################################################################################################################################################################
