##########################################################################################################################################
#........................................................................................................................................#
#======================...........#===========..===========.........=======..===============...==========...=======...===============..==#
#.................................#..................====...........=====..........======........................=======.................#
#=================================#========..==============================#============.=============..=#===#========.#..====...........#
#======.===========#==============#======..=================.......========#========...======...=========#===#=========#=================#
#.#....============#..............#........................................#.............................#...#.........#.....====........#
#.#...............................#......................................#.#.............................#...#.........#.................#
#.#..........=====................#........................................#......#......................#...#.........#.................#
#.#................#..............#........................................#......#......=====..===......#...#.===.....#.................#
#.#................#..............#......................................#.#......#..........#...........#...#.........#.................#
#.#..==============#==^^^^^^=========^^^^=============...........========#.#..====#==========#===========#===#....=====#====.============#
#...........S======#===...............^^^^^^.............................#.#......#..........................#.........#.............===.#
#..........=======================================................................#..........................=========.#.................#
#..................#..............................................................#....................................#.................#
#..................#..............................==..^^^^^.............=.........#....................................#.................#
#..................#..............................................................#..........======^^^^^^....................*...........#
#..................#................................=======......======...........#...........^^^^................============...........#
#....==========....#===..............=====.....===============^^^^=======.........#===......=============^^^====...^^^^================.G#
#..................................................................^^^^^.............................................====================#
#........................................................=================..======..====...===......==...==============..................#
#============..=======================================================================================================..=================#
##########################################################################################################################################
