##########################################################################################################################################################
#.................................==..............................========..............................................................====.............#
#...............................=====...................==............=...=.................................................................=............#
#...====.......................==....=.....#..............=............=...=...............#...............................====..............=...........#
#.............................==..#.#.=....#...............=............=...=.................................................................=..........#
#.....======......=============.....====.===========........=...==================...==========....====..===========.========.............===============#
#...........................==....#........#.................=...........==...=............#....................................................=........#
#..........................==.....#.......................=====.........=..=====...........#...................=============...............===...=.......#
#......===................====......#......#.............=.....=.......=..===..............#...................................................=======...#
#.......=...=========....=..........#.==................=.......=.....=..................................................................................#
#======================================....=============....======.========........===============..======......===================....==========...=====#
#.........=..........=.===........#.=.............=.===.............=..=...===.....................=................................................====.#
#..........=..........=...........==#===...........=.=..........====....=.==..=............#......=.....................................#................#
#...........=........2.=......=====.................=.=.....====.........=.=...=...====..........=....7..................................................#
#....==================.=.......====#..===================..=================..================.=....==================================.#...=============#
#.............=..=====^^^^^^^==================...=====.=....===================^^============.=.=========================.....=====....#...=============#
#.........S....====...======..===................=.....=.=..................=.=..^^^^^^^^.===.===.^^^^^^^.=======...^^^^.==========...^^^................#
#........======================............#....=.......=.==..............==========================================......^^^^^^^^.......................#
#...........................==....#.#..........=.........=..===...............=.=...=.............=................======================................#
#..........................=====..............==....8.....=......^^^======.....=.===.=.....#.....=......................................................G#
#.......................===...=====................===..====.......^^^^^^.......=......====.....=.......====...............................==============#
#======..=================================================..=.===========...========...======...======.....=======..====...=========......===============#
#....=..................=.==...................====^^^^...=......................==......................................................................#
#.....=................=...=================.......===========...........................................................................................#
#......=..............=.....=...............................=...............................=............................................................#
#.......=.........====.......=.............................................................=.............................................................#
#........==...................===........................................................................................................................#
#....==================....======..==================================================================.....===============================================#
##########################################################################################################################################################
