######################################################################################################################################
#...............==...==.........................................................................................====..........===....#
#.................=....=.........................========........................===.............========......=.............===.....#
#.............===========...................====....=.............====..............=..........===............=.............=........#
#...................=................................=................======.........=............=..........=.............====......#
#===========....=================..=======.....==========...#==============================.......======....=========================#
#.=====================================.......====================================.....=....=========================================#
#......................=................................=...#...........==..............=====........=....==............====.........#
#.....................===..............................===.............=..=..............=............=....===..=========...=........#
#....................................................=======..........=..===..............=............=..=...#....===.......=.......#
#....................................................................=.....................=............==....................=......#
#..................................===......................#.......=......................==...........======#=========.......=.....#
#=======....=========================================....=============...===================..======..======..=====.......=====.=....#
#.....................#..........................====........=.====............=====..=========.......=..===..#=.................==..#
#................#..................===================.....=.....................=..................=........#.=....................#
#................#....#...............=======..=...........=#.....6................=................=............=...................#
#................#............................=...........=.#....==.................=..............=..............=..................#
#................#...................................^^^^^..#...........2............=............=................=.................#
#................#.................==.........=........====............=........................=====............=..=................#
#.S....................^^^^^^^..............=================.================..==..............==....==4...........==...............#
#==========......#...........====............^^^^....=..==========......^^^^^...=.......=.....4=......===...............=====....=..G#
#==============^^^^^^..===========================.=============================.........=.=============....=========================#
#..............==..==.............................===..=......................=...........=..=^^^^^^^^^..............................#
#..........==..========.................................====................==..=========================............................#
#====================================================================..=======================================================..=====#
######################################################################################################################################
