#######################################################################################################################
#.....................................................................................................................#
#=======..==============================#==.....================.....===#=========..=========================.....====#
#....=======..........#.................#===#=..........................#.................................#...........#
#.....................#.............====#===#=..........................#.................................#...........#
#....................=#==...............#...#...........................#.................................#...........#
#.....................#.................#...#.......========............#.................................#...........#
#============....=====#==............===#===#=====================.....=#==..=======.===========.....=====#====#======#
#.....========..======#=================#===#===========..==============#===#======#=================.....#....#=====.#
#.....................#.................#...#...........................#===#=.....#......................#....#......#
#....=========.............=========^^^^^=============.....=============#===#...........==================#====#======#
#.................S.........^^^^........#.^^^^^................=^^^^^^=========.........====..^^^^^^......#....#......#
#................========.======.==============............=====^^^^^^..^^^^^^..........^^^...............#....#......#
#.......................................#......=====.=============================...........=======......#====#====..#
#.......................................#.............................=====.#.....===========.............#....#......#
#.......................................===.....................................................=============..#===...#
#..............................................................................................................#......#
#...........................................................................#........................................G#
#............................................................................................................=========#
#============================...================================================================.........=============#
#######################################################################################################################
