#########################################################################################################################################################################################################################
#............................==..........................=======...........................................................................................====.........................................................#
#..............................=.............................=..=..............................................................................................=........................................................#
#...........................===========.......................=..=.............................................==..==============..............==========.......=..=======......................============............#
#.................................................==...........====..........===...............................=.................................................=......................................................#
#.............=================.......===============....====...=.............=.========....................=======..........=========.................========...=....===========.................=================....#
#...............................................=...............==...........=.............................====...............................................==============............................................#
#..............................................=....====....................=........................===..=.=.......................................................=............======.............===.................#
#.............................................=............................=..........................=..=.=...................====.............................====.=...............................=..................#
#=====............==========================.=.======.........=====.......=..==============================..========...........=.........=====...................===...===============================.................#
#...........................................=.........====...............=.............................===.......................=...............................=.....=...............................=................#
#=======...................====............=......=================.....=....===...........========...=.==...........=========....=..===============........==.======.===...............................=...............#
#..................#........====......======...........................=......=.===..................=.=..=........................=.====......................=.........................................=..............#
#..........................=............=.............................=......=.....====.............=.=....=........................=.........................=...........................................=.............#
#.........................=............=..=====......................=......=.....=.=.............=====.....===......................=.....====..............=.............................................=............#
#...===............#...======.........=.............................=......=.....=...=................................................=.....=...............=...............................................=...........#
#....=...........======.=............=...........................===......=.....=.....=...............==...........==========..........=.....=........===..=.................................................=..........#
#============================================...............===========.=======================.......=..........====================......================.................===========.......................=.........#
#......=..............=............=....................................=.....=.=====...===..........=.====.........................=======....=......=..=.....................................................=........#
#.......=............=............=....................................=.....=......==========......=....==========............#......=...=.....=....=..=...................................=====...............=.......#
#........=.........#=....=====...=................................=====.....=.............=.#......=......=....................#.=====.....=.....=..=..=.........................................................===....#
#...========.......=..........====................................====.....====....======..=#.....=......====..................#....==......===...=====.................................................................#
#.................==...........=..................................=...=.....................=....=......=......................#...=..=...........==.......========.....................................................#
#................................................................=.....=....................#====......=..........................=....=.........=..=......................................=====........................#
#...............................8...............................=.......=...................#.==......=........................#.=......=.......=....=..................................................................#
#...............................=..............................=.......===..................#........=..........................=........=..======....=......=.......^^^^^^.....2..................^^^^^................#
#.............==...............========.......................=.............................#.......=..........................=.....==...=...=........=.....^^^^^^^...........==.....................=========........G#
#.............=......S..........^^^^^^.......................=......==.............................=............==............=.....==.....=.=..........==..=........======......======.........========^^^^^^.=========#
#..................#==================......................====^^^^^=3=================...=#=======..........=======..===============.....==......==================.......==....^^^^...............=========..........#
#.........................................5.................===....==.==^^^^^^^^^................=.............^^^^^....^==^..^^^^^^^........=...^^^......=.......===.....============.=======..........................#
#......................................=.^=^^==========....======================.7.............=........==============================...=====..........=....................=...........................=========.....#
#.......................................=.....^^^^^^.............==...............===....===^^==========^===.....................=..........====.===....=......................=........................................#
#...=.............................==================............==..........===...........^^^^^^^^^^^^^^^^^.....................=......................=........................=.......................................#
#====.........=============............=..................=================....====..======================.....====..........====....................=....===....=..............=..====...............====.............#
#.............................................................==..............................................................=..=...................=............................=.....................................#
#.........................................................=====..............................................................=.===...............====..............................====.................................#
#=========.....===================================================================...==============....=====================================..=========================================...=====.....====================#
#########################################################################################################################################################################################################################
