########################################################################
#......................................................................#
#....................*....................*....................*.......#
#..............====..............====..............====................#
#......................................................................#
#....U...............B....................^^^^^........................#
#.........................====..........................====...........#
#......................................................................#
#..............^^^^.................*.........................^^^^.....#
#.....................====....................B...........====.........#
#......................................................................#
#...........B............................====..........................#
#....................====...........^^^^^.............====.............#
#......................................................................#
#..S.............====...........*..................D..............G....#
########################################################################
