########################################################################################
#....==.............................==....===..............===...===.....===...........#
#...=.................................=..=...................==.=.......=..............#
#..===............==========...........==.....................=====....=...............#
#.....==========================================================......=..........======#
#..............................=======...=.====.............1...=....=.................#
#...............^^^^====.........===========^^^^.........^^==^...=..=..................#
#.....=======....^^^^^^.==========^^^^.=....=.....................===..................#
#............=======================================..==============...................#
#.....S..................................==......................====..................#
#============....=========================================.....=======================G#
#.....==============================....==================.....========================#
#....==============.....===========.....===========.======.....====================..==#
#............====.==....................==========.................==========..=.......#
#.............=.........................==.............................=...............#
#..............=.........................=====..........................=....=.........#
#...............==................==......==.............................====..........#
#===============================================================================.....==#
########################################################################################
