###############################################################################################
#.............................................................................................#
#=====.......=============...=====.===========..........======================================#
#...................................=====#====.......................#....................#...#
#......#............=======....#.......==#=..........................#.......======.......#...#
#......#.......................#.........#...........................#....................#...#
#.=====#===....................#.........#...........................#..............#.....#...#
#.=====#====....===============#=.......=#==#================...=====#====...=======#=====#..=#
#.............................=#========.#..#........................#....======....#.....#...#
#......S..............========.#.......=====^^^^^^.........=======...#.^^^^^^.......#....=#...#
#....===========.......^^^^^^..#........^^^^................^^^^^....#........======#.....#...#
#...............================..===========================================.......#.....#...#
#.========.................====#===....=================================.......==============G#
#..............................#....................................................==========#
#.............................................................................................#
#..========...===============....=============================================================#
###############################################################################################
