########################################################
#......................................................#
#......................................................#
#....................====..............................#
#......................................................#
#............^^^^^.....................................#
#..........................................====........#
#.......................B..............................#
#..S......*......====.........^.....U.............G....#
########################################################
