########################################################
#.........................................*............#
#.........................................===..........#
#........................................=.............#
#..................................===.................#
#...............................=......................#
#...........................===............====........#
#......................==..............................#
#..S.............====..........^^^^^^^............G....#
########################################################
