###################################################################################################
#.....................===......====...............................................==....====......#
#..........==...........==....=...........................============...........=.....=..........#
#===================...=======================......================......=========...============#
#....#........=.......=======........=======......................=.===........=.....=....=======.#
#....#.........=..===....====........====........................=...==.......=.....====..........#
#...............=..=........=.......=========...................=....#.....#.=....==..............#
#....#======.....==..........=.....=..........====.............=...........#=.....===.............#
#...............===...........=...=..........=................=......#.....=......................#
#=======================......==========....=.====================================================#
#===============================================================.....#..==============.......=====#
#....==........................=..........=........====............==#=====#...........==.........#
#....#........................=..........=..........=...................=..#.............=........#
#..............====..........=..........=............=.....3.......*...=..................=.......#
#...........................============..............=....=.......====........====........=......#
#...========....................^^^^^^====........======...^^^^4.....=.......========.....==......#
#........======S........===........................^^^..=.....==....=.........^^^^^^.......=......#
#===========================================================================================.....G#
#.......................=.................................=......==................^^^^^.=========#
#........................====.....................................................========........#
#=============================================....================================================#
###################################################################################################
