########################################################################################################
#......................................................................................................#
#.................................====......................==.............======......................#
#................................................========......................................#..#....#
#===========..=======.....================....===================.......========#=.....========#==#==.G#
#..................=========........===...............................*...^^^...#..........============#
#=========================^^^^^.=======^^^^^=====================..============.#....==========#=##====#
#...................^^^^^^.=========...======^^^^^..........................===============....#.##....#
#====================================.===========================#==============#========#=====#=##====#
#......S.....========..#.........===..=======.......^^^^^^.......#.^^^^.........#........#.....#.#.....#
#.....============.....=========...................========.===========.........#........#.......#.....#
#.=========.....======#======..========...======================.#=============.......===#============.#
#..===..............................................======...............................#.....#.......#
#..............................................................................................#.......#
#......................................................................................................#
#......................................................................................................#
#==============........========================.....====================================........=======#
########################################################################################################
