############################################################################
#..........................................................................#
#...........*......................*......................*...............#
#......====.................====.................====......................#
#..........................................................................#
#....U...........B....................^^^^^....................B..........#
#.....................====.............................====...............#
#..........................................................................#
#..........^^^^...............*..................^^^^...............*.....#
#................====..................B..................====............#
#..........................................................................#
#.....B....................====......................====.................#
#...................====...........^^^^^...........====...................#
#..........................................................................#
#.............*..................D......................*.................#
#................====............................====.....................#
#..........................................................................#
#..S........====...........*...........d.............====............G.....#
#..........................................................................#
############################################################################
